11111111111111
1000000S000001
11111111111111
