NO ./parsing/textures/netherite.png
SO ./parsing/textures/netherite.png
EA ./parsing/textures/netherite.png
WE ./parsing/textures/netherite.png

F 0,0,0
C 0,0,0

1111111111111111111111111
1S10010100000000000000001
1000000000000000000000001
1000000000111111111111111
1000000000000000000000001
1000000000111111111111111
1111111111111111111111111