NO ./parsing/textures/mur.png
SO ./parsing/textures/cat.png
EA ./parsing/textures/milouche.png
WE ./parsing/textures/cobblestone.png

F 0,0,0
C 0,0,0

1111111111111111111111111
1010010100000000000000001
1000000000000000000000001
1000000000111111111111111
1000S00000000000000000001
1000000000111111111111111
1111111111111111111111111