NO ./parsing/textures/mur.png
SO ./parsing/textures/cat.png
EA ./parsing/textures/milouche.png
WE ./parsing/textures/cobblestone.png

F 128,0,128
C 0,0,255

11111111111
10100101001
10000000001
10000000001
1000S000001
10000000001
11111111111