11111111111
10000000111
10000001111
11111111111
