NO ./textures/titi.jpg
SO ./textures/cow.jpg
		EA          ./textures/panda.jpg

F 220,100,0
C 225,30,0
WE ./textures/spider.jpg

            1111111 111  1111111111111
            1000000 00011000000000001 11111111
            1011000 00111000000000001 1111111
            1001000 000000000000000001 1111111111
    111111111011000 001110000000000001 11111111111
    100000000011000 001110111111111111 111111111111
    111101111111110 11100000010001 11111111111
    111101111111110 11101110010001 111111111111               
    110000001101010 11100000010001  11111111111111                         
    100000000000000 01100000010001 11111111111
    100000000000000 01101010010001 11111111111
    110000011101010 11111011110S00 111111111111
    11110111 111010 1 101111010001 11111111111
    11111111 111111 1 111111111111 111111111111111






