NO ./textures/H.png
SO ./textures/netherite.png
EA ./textures/netherite.png
WE ./textures/netherite.png

F 0,0,0
C 0,0,0

1111111111111111111111111
1N10010100000000000000001
1010000000000000000000001
1010000000111111111111111
1000000000000000000000001
1000000000111111111111111
1111111111111111111111111
