NO ./textures/titi.jpg
SO ./textures/cow.jpg
		EA          ./textures/panda.jpg

F 220,100,0
C 225,30,0
WE ./textures/spider.jpg

1111111111111
10S0000100111
100001000011
111111111111
